failed_word	gold_line	gold_pattern	predicted_pattern
Χρι_στι^α_νῶν	οἶδ' ὅπως πρὸς τὰ_ς Κέλσου κα^τὰ^ Χρι_στι^α_νῶν ἐν συγγράμμα^σι^	HLHHHHHLHHLHHHHHLL	HLHHHHHLL--HHHHHLL
πι^θα^νότητα^	καὶ ταῖς κα^τηγορί^αις μηδὲ πι^θα^νότητα^ εἰς τὸ δύ^να^σθαί τι^	HHLHLLHHLLLLHLHLLHHL	HHLHLLHHL-LLHLHLLLHL
ἐνδιδόντος.	αὐτὰ_ς ἐνδιδόντος. Περὶ^ δὲ τοῦ Ἰησοῦ ὅτι^ ἐσι^ώπα_	HHHHHHLLLHHHHLLLLHH	HHH-HHLLLHLHHLLLLHH
ἰ_σοδυ^να^μοῦντα^	πα^ρα^θέσθαι· τὰ^ γὰ^ρ ἰ_σοδυ^να^μοῦντα^ αὐτῷ ὁ Μάρκος ἔγραψεν.	LLHHLLHLLLHLHHLHLHHH	LLHHLLLLLLHLHHLHL-HH
λέξι^ς·	Ἔχει δ' οὕτως ἡ τοῦ Ματθαίου λέξι^ς· Ὁ δὲ ἀρχι^ερεὺς	LHHHHHHHHHHLLHLLH	LHHHHHHHHHLLLH-LH
ἀρχι^ερεὺς	Ἔχει δ' οὕτως ἡ τοῦ Ματθαίου λέξι^ς· Ὁ δὲ ἀρχι^ερεὺς	LHHHHHHHHHHLLHLLH	LHHHHHHHHHLLLH-LH
συ^νέδρι^ον	καὶ τὸ συ^νέδρι^ον ἐζήτουν ψευδομαρτυ^ρί^α_ν κα^τὰ^ τοῦ Ἰησοῦ,	HLLHLLHHHHLHLLHLLHHHH	HLL--LHHHHLHLLHLLHLHH
σι^δήρῳ	σι^δήρῳ καὶ ἀ^πα^θὴς τὸ σῶμα^ πλασσόμενος, εἶτα^	LHHHLLHLHHHLLLHL	-HHHLLHLLL-LLLHL
'σχί^σα^ς	κα^τα^δὺ_ς ἄτρωτος ὑ^πὸ γῆν 'σχί^σα^ς ὀρθῷ ποδὶ^ γᾶν·	LLHHHLLLHLLHHLLH	LLH-HLLLHLHHHLLH
ἀ^πολι^όρκητος	πα^λαίειν ἀ^ήττητός ἐστι^ καὶ περι^τειχι^ζόμενος ἀ^πολι^όρκητος 	LHHLHHLHLHLLHHLLLLLLHHH	LHHLHHLHLHLLHLLLLLL-HHH
ἀ^νά^λωτος,	καὶ πωλούμενος ὑ^πὸ τῶν πολεμί^ων ἀ^νά^λωτος, οὐθὲν	HHHLLLLHLLLHLLHLHH	HHHLLLLHLLLHLHHLHH
Εὐρι_πί^δου	Ὁ Εὐρι_πί^δου Ἰ^όλα_ος ἐξ ἀ^δρα^νοῦς καὶ πα^ρήλι^κος εὐχῇ	LHHLHLLHLHHLHHLHLLHH	LH-LHLLLLH-LHHLHLLHH
Ἰ^όλα_ος	Ὁ Εὐρι_πί^δου Ἰ^όλα_ος ἐξ ἀ^δρα^νοῦς καὶ πα^ρήλι^κος εὐχῇ	LHHLHLLHLHHLHHLHLLHH	LH-LHLLLLH-LHHLHLLHH
κα^τ'	ἀ^ρετὴν καὶ γέγονεν ἐκ ῥυ_σοῦ καὶ ὠχροῦ καὶ κα^τ' Αἰσχύ^λον	LLHHLLLHHHHHHHHHLH	LLHHLLL-HHHHHHLHLH
ἀ^πὸ	Ζεὺς μὲν ἀ^φίκτωρ ἐπί^δοι προφρόνως στόλον ἡμέτερον νάιον ἀρθέντ' ἀ^πὸ προστομί^ων λεπτοψα^μά^θων Νείλου. Δί_α_ν δὲ λι^ποῦσαι	HLLHHLLHLLHLLHLLHHLLHHLLHLLHHHLLHHHHHLLHH	HLLHHLLH-LHLLHLLHHLHHL-HLLHHHLLHHHHHLLHH
λεπτοψα^μά^θων	Ζεὺς μὲν ἀ^φίκτωρ ἐπί^δοι προφρόνως στόλον ἡμέτερον νάιον ἀρθέντ' ἀ^πὸ προστομί^ων λεπτοψα^μά^θων Νείλου. Δί_α_ν δὲ λι^ποῦσαι	HLLHHLLHLLHLLHLLHHLLHHLLHLLHHHLLHHHHHLLHH	HLLHHLLH-LHLLHLLHHLHHL-HLLHHHLLHHHHHLLHH
φυξα_νορί^αν,	ἀλλ' αὐτογενεῖ φυξα_νορί^αν, γά^μον Αἰγύπτου παίδων ἀ^σεβῆ τ' ὀνοταζόμεναι δι^ά^νοια^ν.	HHLLHHHLLHLLHHHHHLLHLLHLLHLLHH	HHLLHHLLLHLLHHHHHLLHLLHLLHLLHL
Κρονί^δα_ο	εἰπέ, θεά_, Κρονί^δα_ο δι^άκτορον αἴθοπος αὐγῆς,	HLLHLLHLLHLLHLLHH	HLL-LLLL-HLLHLLHH
δι^άκτορον	εἰπέ, θεά_, Κρονί^δα_ο δι^άκτορον αἴθοπος αὐγῆς,	HLLHLLHLLHLLHLLHH	HLL-LLLL-HLLHLLHH
πυ^ρὸς	Βάκχου δισσοτόκοιο, τὸν ἐκ πυ^ρὸς ὑγρὸν ἀ^είρα_ς	HHHLLHLLHLLHLLHH	HH-LLHLLHHL-LLHH
πότνι^α^	ἄ^ρσενι^ γαστρὶ^ λόχευσε, πα^τὴρ καὶ πότνι^α^ μήτηρ,	HLLHLLHLLHHHLLHH	LLL-LLHLLHH--LHH
ἐγκύ_μονι^	ἄσπορον ὄγκον ἄ^πι^στον ἔχων ἐγκύ_μονι^ κόρσῃ,	HLLHLLHLLHHHLLHH	-LLHLLLLLHHLLLHH
τι^νάξα^τε	ἄ^ξα^τέ μοι νάρθηκα^, τι^νάξα^τε κύ^μβα^λα^, Μοῦσαι,	HLLHHHLLHLLHLLHH	LLLHHHL-HLLLLLHH
Δι^ονύ_σου:	καὶ πα^λά^μῃ δότε θύρσον ἀ^ειδομένου Δι^ονύ_σου:	HLLHLLHLLHLLHLLHH	HLLHLLHLLHLLH-LLH
Δι^ονύ_σου:	καὶ πα^λά^μῃ δότε θύρσον ἀ^ειδομένου Δι^ονύ_σου:	HLLHLLHLLHLLHLLHH	HLLHLLHLLHLLH-LLH
Γι^γά^ντων:	φρικτὰ^ δρα^κοντοκόμων ἐδα^ΐ^ζετο φῦλα^ Γι^γά^ντων:	HLLHLLHLLHLLHLLHH	HLLHLLHLLLLLHL-HH
Κρα^τύ_λος	Κρα^τύ_λος φησὶ^ν ὅδε, ὦ Σώκρα^τες, ὀνόμα^τος ὀρθότητα^ εἶναι ἑκάστῳ τῶν ὄντων φύ^σει πεφυ_κυῖα^ν, καὶ οὐ τοῦτο εἶναι ὄνομα^ ὃ ἄ^ν τι^νες συ^νθέμενοι κα^λεῖν κα^λῶσι^, τῆς αὑτῶν φωνῆς μόρι^ον ἐπι^φθεγγόμενοι, ἀλλὰ^ ὀρθότητά^ τι^να^ τῶν ὀνομά^των πεφυ_κέναι καὶ Ἕλλησι^ καὶ βα^ρβά^ροις τὴν αὐτὴν ἅ^πα_σι^ν.	LHHHLLLHHLLLLLHHLHLHHLHHHHHLHLHHHHHHLHHLLLLHLHHLLHLHLHLHHHHHLLLLHHLLHHLHLHLLLHLLLHLHLHHHHLHHLHHHHLHH	LLHHLLLHHLLLLLLHLHLHHL-HHHHLHLHHLHHHLHHLLLLHLHHLLHLHLHLHHHHHLLLLHHLLHHLHLHLLLHLLLHLHLHHHHLHLLHHHHLHL
Κρα^τύ_λος	ἐρωτῶ οὖν αὐτὸν ἐγὼ εἰ αὐτῷ Κρα^τύ_λος τῇ ἀ^ληθείᾳ ὄνομα^ ἐστὶ^ν ἢ οὔ· ὁ δὲ ὁμολογεῖ. 	LHHHHLLHHHHLHHHLHHHLLLHLHHLLLLLH	LHHHHLLHHHHLLHHLHHHLLLHLHHLLLLLH
Κρα^τύ_λου	εἰ οὖν πῃ ἔχεις συ^μβα^λεῖν τὴν Κρα^τύ_λου μα^ντεία_ν, ἡδέως ἂ^ν ἀ^κούσαιμι^·	HHHLHHLHHLHHHHHHLHLLHHL	HHHLHLLHHLLHLHHHLHLLHHL
Πρι^ά^μοιο	δὴ τότε Τρῶες ἔμιμνον ἀ^νὰ^ Πρι^ά^μοιο πόληα^	HLLHLLHLLHLLHLLHL	HL-HLLHLLL-LHLLHL
θρα^σύφρονος	δειδι^ότες μένος ἠῢ^ θρα^σύφρονος Αἰα^κί^δα_ο:	HLLHLLHLLHLLHLLHL	HLLHLLH-H-LLHLLLL
Αἰα^κί^δα_ο:	δειδι^ότες μένος ἠῢ^ θρα^σύφρονος Αἰα^κί^δα_ο:	HLLHLLHLLHLLHLLHL	HLLHLLH-H-LLHLLLL
ἀ^νὰ^	ἰ_ληδὸν πτώσσουσαι ἀ^νὰ^ ῥωπήι^α^ πυκνά^:	HHHHHLLHHHLLHL	HHHHHHLLHHL-L
πυκνά^:	ἰ_ληδὸν πτώσσουσαι ἀ^νὰ^ ῥωπήι^α^ πυκνά^:	HHHHHLLHHHLLHL	HHHHHHLLHHL-L
ὄβρι^μου	ὥς οἱ ἀ^νὰ^ πτολί^εθρον ὑ^πέτρεσα^ν ὄβρι^μου ἄ^νδρα^	HLLHLLHLLHLLHLLHL	HHLLLL-LL-LL--HHL
δι^᾽	ἄλλους θ᾽ ὡς ἐδά^ϊξε δι^᾽ ἀ_κα^μά^τοιο θα^λάσσης	HHHLLHLLHLLHLLHH	HHHLLHLLLLLHLL-H
ἀ^νι_ηρὸν	ἀμφὶ^ δ᾽ ἄ^ρα^ σφί^σι^ πένθος ἀ^νι_ηρὸν πεπότητο	HLLHLLHLLHHHLLHL	HLLLLLHLL-HHLLHL
πυ^ρὶ^	ὡς ἤδη στονόεντι^ κα^ταιθομένης πυ^ρὶ^ Τροίης.	HHHLLHLLHLLHLLHH	HHHLLHLLHLLHHLHH
πνεύμα^τι^	ὄμμα^σι^ νωθρὰ^ βλέπουσα^· τὰ^ δ᾿, ἠύτε πνεύμα^τι^ φύλλα^,	HLLHLLHLLHHHLLHL	HLLHLLHLLHL-HLLLL
πρί^ων	ἀλλ’ αὐτὸς ἔφερε πάντα^ χὠ πρί^ων ἀ^πῆν.	HHLLLLHLHLHLH	HHLLLLLLHHHLH
Εἴσα^γ’,	ὁ δ’ ἀ^νεῖπεν· Εἴσα^γ’, ὦ Θέογνι^, τὸν χορόν.	LLHLHLHLHLHLH	LLHLHHHL-LHLH
κα^τέσχε	ἐπεὶ οὐδὲ Κλεομένης, ὃς αὐτὴν κα^τέσχε πρῶτος,	LHLLLLHLHHLHLHH	LHH-LLLHLHHLH-HH
ἐξι^πώκα^τον.	ὡς ἐμοῦ γε τὼ ξύ^λω τὸν ὦμον ἐξι^πώκα^τον.	HLHLHLHLHLHLHLL	HLHLHLHLHLH-HLH
ἀ^ποσβεσθὲν	μή μ' ἀ^ποσβεσθὲν λά^θῃ πρὸς τῇ τελευτῇ τῆς ὁδοῦ.	HLHHHLHHHLHHHLH	HLHHHHHHHLHHHLH
ἀρήξομεν;	Ἢ πότ' αὐτῇ μᾶλλον ἢ νῦν, ὦ Λά^χης, ἀρήξομεν;	HLHHHLHHHLHHHLH	HLHHHLHHHLHLHLH
Νι_κοδί^κη,	Πέτου πέτου, Νι_κοδί^κη, πρὶ^ν ἐμπεπρῆσθαι Κα^λύ^κην τε καὶ Κρί^τυλλαν περι^φυ_σήτω	LHLHHLLHLHLHHLLHLHLHHLLHHH	LHLH-LLHLH-HHLLHLHHHLL-HHH
Κρί^τυλλαν	Πέτου πέτου, Νι_κοδί^κη, πρὶ^ν ἐμπεπρῆσθαι Κα^λύ^κην τε καὶ Κρί^τυλλαν περι^φυ_σήτω	LHLHHLLHLHLHHLLHLHLHHLLHHH	LHLH-LLHLH-HHLLHLHHHLL-HHH
περι^φυ_σήτω	Πέτου πέτου, Νι_κοδί^κη, πρὶ^ν ἐμπεπρῆσθαι Κα^λύ^κην τε καὶ Κρί^τυλλαν περι^φυ_σήτω	LHLHHLLHLHLHHLLHLHLHHLLHHH	LHLH-LLHLH-HHLLHLHHHLL-HHH
κνεφαία_	Νυνδὴ γὰ^ρ ἐμπλησα^μένη τὴν ὑ^δρί^αν κνεφαία_	HHLHHLLHHLLHLHH	HHLHHLLHH-LHLHL
ἀ_ρα^μένη,	ἀ_ρα^μένη, ταῖσι^ν ἐμαῖς δημότι^σιν κα_ομέναις	HLLHHLLHHLLHHLLH	LLLHHLLHHL-LLLLH
δημότι^σιν	ἀ_ρα^μένη, ταῖσι^ν ἐμαῖς δημότι^σιν κα_ομέναις	HLLHHLLHHLLHHLLH	LLLHHLLHHL-LLLLH
κα_ομέναις	ἀ_ρα^μένη, ταῖσι^ν ἐμαῖς δημότι^σιν κα_ομέναις	HLLHHLLHHLLHHLLH	LLLHHLLHHL-LLLLH
τυ_φογέροντα_ς	Ἤκουσα^ γὰρ τυ_φογέροντα_ς ἄνδρα^ς ἔρρειν, στελέχηφέροντα^ς ὥσπερ βα^λα^νεύσοντας	HHLHHLLHHHLHHLLHLHLHHLLHHL	HHLLHLLHLLLHHLLHLHLHHLLHHL
πυ^ρὶ^	ὡς πυ^ρὶ^ χρὴ τὰς μυ^σα^ρὰς γυ^ναῖκα^ς ἀνθρα^κεύειν.	HLLHHLLHLHLHLHH	HHLHHLLHLHLHLHH
θεά_,	Ἅ_ς, ὦ θεά_, μή ποτ' ἐγὼ πιμπρα^μένα_ς ἴ^δοιμι^,	HHLHHLLHHLLHLHL	HHLLHLLHHLLHLHL
χρυ_σολόφα_	ἐφ' οἷσπερ, ὦ χρυ_σολόφα_	LHLHHLLH	LHLHHLLL
κα^μα^τήρι^ος.	οὐδὲ γόνα^τ' ἂν κόπος ἕλοι με κα^μα^τήρι^ος.	HLLLHLLLHLLLHLL	HLLLLLLLHLLLH-H
τουτῳὶ_	Ἀλλ' ἐπα^ποδυ^ώμεθ', ὦνδρες, τουτῳὶ_ τῷ πρά_γμα^τι^.	HLLLLHLHLHLHHHLL	HLLLLHLHHHHLH-LL
ἐξεπά_ρωσιν	τὰς θεοῖς ἐχθρὰς γυ^ναῖκα^ς ἐξεπά_ρωσιν δόλῳ	HLHHHLHLHLHHHLH	HLHHHLHLHLLHLLH
κἀ_κα^νηφόρουν	κἀ_κα^νηφόρουν ποτ' οὖσα^ παῖς κα^λὴ 'χουσ' ἰσχά^δων ὁρμα^θόν.	HLHLHLHLHLHHHLHHLH	LLHLHLHLHLHH-LHHLH
κἀ_πι^δώσειν	κἀ_πι^δώσειν μοι δοκεῖ τὸ χρῆμα^ μᾶλλον.	HLHHHLHLHLHL	L-HHHLH-HLHH
κἀ_πι^δώσειν	κἀ_πι^δώσειν μοι δοκεῖ τὸ χρῆμα^ μᾶλλον.	HLHHHLHLHLHL	L-HHHLH-HLHH
Λειψύ^δρι^ον	Ἀλλ' ἄ^γετε λευκόποδες, οἵπερ ἐπὶ^ Λειψύ^δρι^ον	HLLLHLLLHLLLHLLL	HLLLHLLLHLLLH--H
κἀ_ναπτερῶσαι	νῦν δεῖ, νῦν ἀ^νηβῆσαι πά^λιν κἀ_ναπτερῶσαι	HHHLHHHLHHHLHH	HHHLHHHLLLHLHH
κἀ_ποσείσασθαι	πᾶν τὸ σῶμα^ κἀ_ποσείσασθαι τὸ γῆρας τόδε.	HLHLHLHHHLHHLL	HLLLLLH-HLHLLL
ἂ^ν	ὡς ἂ^ν ὄζωμεν γυ^ναικῶν αὐτοδὰξ ὠργισμένων.	HLHHHLHHHLHHHLH	HHHHHLHHHLHH-LH
ἵ^να^	Νῦν πρὸς ἔμ' ἴ^τω τι^ς, ἵ^να^ μήποτε φά^γῃ σκόροδα^,	HLLLHLLLHLLLHLLL	HLLLHLLHHLLLHLLL
Κἀ_γὼ	Κἀ_γὼ βούλομαι μῦθόν τι^ν' ὑ_μῖν ἀντι^λέξαι τῷ Μελα^νί^ωνι^.	HHHLHHHLHHHLHHHLLLHL	LHHLHHH-HHH-HHHLLLHL
τι^ν'	Κἀ_γὼ βούλομαι μῦθόν τι^ν' ὑ_μῖν ἀντι^λέξαι τῷ Μελα^νί^ωνι^.	HHHLHHHLHHHLHHHLLLHL	LHHLHHH-HHH-HHHLLLHL
ἀντι^λέξαι	Κἀ_γὼ βούλομαι μῦθόν τι^ν' ὑ_μῖν ἀντι^λέξαι τῷ Μελα^νί^ωνι^.	HHHLHHHLHHHLHHHLLLHL	LHHLHHH-HHH-HHHLLLHL
δύ^'	δεῖται λα^βεῖν, μνᾶς ἢ δύ^' ἢ τρεῖς· ὡς ἔσω 'στὶν κἄ_χομεν βαλλάντι^α^.	HHLHHHLHHHLHHHLHHHLL	HHLHHHHHHHLHHLLHLLLL
κἄ_χομεν	δεῖται λα^βεῖν, μνᾶς ἢ δύ^' ἢ τρεῖς· ὡς ἔσω 'στὶν κἄ_χομεν βαλλάντι^α^.	HHLHHHLHHHLHHHLHHHLL	HHLHHHHHHHLHHLLHLLLL
Ἑστι^ᾶν	Ἑστι^ᾶν δὲ μέλλομεν ξένους τι^νὰς Κα^ρυστί^ους, ἄνδρας κα^λούς τε κἀ_γα^θούς.	HLHLHLHLHLHLHLHHHLHLHLH	H-HLHLHLHLLL-LHLLLHLLLH
κἀ_γα^θούς.	Ἑστι^ᾶν δὲ μέλλομεν ξένους τι^νὰς Κα^ρυστί^ους, ἄνδρας κα^λούς τε κἀ_γα^θούς.	HLHLHLHLHLHLHLHHHLHLHLH	H-HLHLHLHLLL-LHLLLHLLLH
οὐχὶ^	καὶ μηδὲν οὕτως εὖ σεσημάνθαι τὸ μὴ οὐχὶ^ τοὺς ῥύ^πους ἀ^νασπά^σαι,	HHLHHHLHHHLHLHLHLHLH	HHLHHHLHHHLHHLHLHL-LH
ἀ^νασπά^σαι,	καὶ μηδὲν οὕτως εὖ σεσημάνθαι τὸ μὴ οὐχὶ^ τοὺς ῥύ^πους ἀ^νασπά^σαι,	HHLHHHLHHHLHLHLHLHLH	HHLHHHLHHHLHHLHLHL-LH
ἀ^νασπά^σαι,	καὶ μηδὲν οὕτως εὖ σεσημάνθαι τὸ μὴ οὐχὶ^ τοὺς ῥύ^πους ἀ^νασπά^σαι,	HHLHHHLHHHLHLHLHLHLH	HHLHHHLHHHLHHLHLHL-LH
ἂ^ν	χἄττ' ἂ^ν ἔνδον ᾖ φορεῖν.	HLHLHLH	HHHLHLH
πυ_ρί^δι^α^	ἔστι^ πα^ρ' ἐμοῦ λα^βεῖν πυ_ρί^δι^α^ λεπτὰ^ μέν,	HLLLHLHHLLLHLL	HLLLHLHLLLLHLH
χοίνι^κος	ὁ δ'ἄρτος ἀ^πὸ χοίνι^κος ἰ^δεῖν μά^λα^ νεα_νί^ας.	LHLLLHLLLHLLLHLH	LHLLLH-LLHLHLHLH
μά^λα^	ὁ δ'ἄρτος ἀ^πὸ χοίνι^κος ἰ^δεῖν μά^λα^ νεα_νί^ας.	LHLLLHLLLHLLLHLH	LHLLLH-LLHLHLHLH
Μα_νῆς	καὶ κωρύ^κους· ὡς λήψεται πυ_ρούς. Ὁ Μα_νῆς δ' οὑμὸς αὐτοῖς ἐμβα^λεῖ.	HHLHHHLHHHLHHHLHHHLH	HHLHHHLHHHLLHHLHHHLH
αἰσχύ^νην	ἡμῖν δ' ἂ^ν αἰσχύ^νην φέροι	HHLHLHLH	HHLHHHLH
βρα^δύ_νειν	ὥστ' εἰκὸς ἡμᾶς μὴ βρα^δύ_νειν ἔστ' ἐπα^να^μενούσας	HHLHHHLHHHLLLLHH	HHLHHHLLHHLLLLH-
σκι^ᾶς	ἀλλ' εἶα^ δεῦρ' ἐπὶ σκι^ᾶς ἐλθοῦσα^ πρὸς τὸ τειχί^ον,	HHLHLHLHHHLHLHLL	HHLHLL-HHHLHLHLH
βρά^δυ_ν'·	καὶ μὴ βρά^δυ_ν'· ὡς τήνδε καὶ δὴ τὴν στρα^τηγὸν ἡμῶν	HHLHHHLHHHLHLHH	HHLLHHLHHHLHLHH
ἄ_κουσαι	χαὖται γὰ^ρ ἄ_κουσαι πά^λαι τὸ σχῆμα^ τοῦτ' ἔχουσιν.	HHLHHHLHHHLHLHH	HHLLHHLHHHLHLHL
Δί^α,	οἰμώζων ἄ^ρα^, νὴ Δί^α, σποδήσεις.	HHHLLHLHLHH	HHHLLHHHLHH
τἀ_πὶ^	οὐ γὰρ τἀ_πὶ^ Χα^ριξένης τά^δ' ἐστίν.	HHHLLHLHLHH	HLLLLHLHLHL
δημοκρα^τούμεθα_.	ἔστι^ δί^καιον, εἰ δημοκρα^τούμεθα_.	HLLHLHHLLHLH	HLLHLHH-LHLL
ἱ_κετεύω,	εἰρημέν' ἐστίν. σὺ^ δέ μοι, φίλτα^τον, ὢ ἱ_κετεύω,	HHLHHLLHHLLHLHH	HHLHLLLHHLLHHLHH
τι^νάσσων	πολύ^καρπον μὲν τι^νάσσων	LLHHHLHH	LLLHH--H
κἀ_πισκώπτων	κἀ_πισκώπτων	HHHH	L-HH
ἀ_ρεῖς	Ἀλλ' ἔμβα_ χὤπως ἀ_ρεῖς	HHHHHHH	HHHHHLH
Θωρυ^κί^ων	κἂν Θωρυ^κί^ων μὴ βούληται.	HHLLHHHHH	HHHLHHHHH
ταινι^οῦσθαι.	παίσαντα^ καὶ σκώψαντα^ νι_κήσαντα^ ταινι^οῦσθαι.	HHLHHHLHHHLHLHH	HLLHHHLHHLLH-HH
κἀ_π'	κἀ_π' εὐτελείᾳ τόδε τὸ σανδα^λίσκον	HHLHHLLLHLHH	LHLHHLLLHLLH
μεμυ^ήμεθ'	ὅσοι μεμυ^ήμεθ' εὐσεβῆ τε δι^ήγομεν	LHLLHLHLHLLHLH	LHLHHLHLHL-HLH
δι^ήγομεν	ὅσοι μεμυ^ήμεθ' εὐσεβῆ τε δι^ήγομεν	LHLLHLHLHLLHLH	LHLHHLHLHL-HLH
περι^πεπλευκότος,	Ταῦτα^ μὲν πρὸς ἀνδρός ἐστι^ νοῦν ἔχοντος καὶ φρένας καὶ πολλὰ^ περι^πεπλευκότος,	HLHLHLHLHLHHHLHHHLLLLHLH	HLHLHLHLHLHHHLLHHLL--HLH
Θηρα_μένους.	δεξι^οῦ πρὸς ἀνδρός ἐστι^ καὶ φύ^σει Θηρα_μένους.	HLHLHLHLHLHHHLH	HLHLHLHLHLHHLLH
Μι^λησί^οις	Οὐ γὰ^ρ ἂν γέλοιον ἦν, εἰ Ξανθί^ας μὲν δοῦλος ὢν ἐν στρώμα^σιν Μι^λησί^οις	HLHLHLHHHLHHHLHHHLHLHLH	HLLLHLHHHLHHHLHHHLL-HLH
ἁ^μί^δ',	ἀ^να^τετραμμένος κυ^νῶν ὀρ χηστρί^δ' εἶτ' ᾔτησεν ἁ^μί^δ', ἐγὼ δὲ πρὸς τοῦτον βλέπων	LLLHLHLHHHLHHHLLLLHLHHHLH	LL-HLHLHHHLHHHLHLLH-HHHLH
τέρψι^ν	Μοῦσα^, χορῶν ἱ^ερῶν ἐπί^βηθι^ καὶ ἔλθ' ἐπὶ^ τέρψι^ν ἀ^οιδᾶς ἐμᾶς,	HLLHLLHLLHLLHLLHLLHHLH	HLLHLLHLLHLHHLLH-LHHLH
Θρῃκί^α_	Θρῃκί^α_ χελι_δὼν	HLHLHH	HLLLHH
ἀ^ηδόνι^ον	ἐπὶ^ βάρβα^ρον ἑζομένη πέτα^λον· τρύζει δ' ἐπί^κλαυτον ἀ^ηδόνι^ον νόμον, ὡς ἀ^πολεῖται, κἂ_ν ἴ^σαι γένωνται.	LLHLLHLLHLLHHHLLHLLHLLHLLHLLHHHLHLHH	LLLLLHLLHLLHHHL-HLLHL-HLLHLLHHHLHLHH
ἐνδι^α^τρίψει·	χρόνον ἐνδι^α^τρίψει· ἰ^δὼν δὲ τά^δ' οὐκ εἰρηνι^κὸς ἔσθ', ἵ^να^ μή ποτε κἀ_ποδυ^θῇ μεθύ^ων ἄ^νευ ξύ^λου βα^δίζων	LLHLLHLLHLLHHHLLHLLHLLHLLHLLHLHLHLHH	LLH--LHLHLLHHHLLHLHHLLLLLHLLHLHLHLHH
ἵ^να^	χρόνον ἐνδι^α^τρίψει· ἰ^δὼν δὲ τά^δ' οὐκ εἰρηνι^κὸς ἔσθ', ἵ^να^ μή ποτε κἀ_ποδυ^θῇ μεθύ^ων ἄ^νευ ξύ^λου βα^δίζων	LLHLLHLLHLLHHHLLHLLHLLHLLHLLHLHLHLHH	LLH--LHLHLLHHHLLHLHHLLLLLHLLHLHLHLHH
κἀ_ποδυ^θῇ	χρόνον ἐνδι^α^τρίψει· ἰ^δὼν δὲ τά^δ' οὐκ εἰρηνι^κὸς ἔσθ', ἵ^να^ μή ποτε κἀ_ποδυ^θῇ μεθύ^ων ἄ^νευ ξύ^λου βα^δίζων	LLHLLHLLHLLHHHLLHLLHLLHLLHLLHLHLHLHH	LLH--LHLHLLHHHLLHLHHLLLLLHLLHLHLHLHH
ἂ^ν	ἡνί^κ' ἂ^ν ὀξύ^λα^λόν περ ἴ^δῃ θήγοντος ὀδόντα^	HLLHLLHLLHHHLLHL	HLHHLLHLLHHHLLHL
πα^ραξόνι^α	σκινδα^λά^μων τε πα^ραξόνι^α σμι_λευμα^τοεργοῦ	HLLHLLHLLHHHLLHH	HLLHLLHL-L-HLLHH
σμι_λευμα^τοεργοῦ	σκινδα^λά^μων τε πα^ραξόνι^α σμι_λευμα^τοεργοῦ	HLLHLLHLLHHHLLHH	HLLHLLHL-L-HLLHH
ἱπποβά_μονα^.	ῥήμα^θ' ἱπποβά_μονα^.	HLHLHLL	HHHLLLL
λοφι^ᾶς	Φρίξας δ' αὐτοκόμου λοφι^ᾶς λα^σι^αύχενα^ χαίταν,	HHHLLHLLHLLHLLHH	LHHLLHL-HL-HLLHH
λα^σι^αύχενα^	Φρίξας δ' αὐτοκόμου λοφι^ᾶς λα^σι^αύχενα^ χαίταν,	HHHLLHLLHLLHLLHH	LHHLLHL-HL-HLLHH
ἐπισκύ^νι^ον	δεινὸν ἐπισκύ^νι^ον ξυ^νά^γων, βρυ_χώμενος ἥσει	HLLHLLHLLHHHLLHH	HLLLL-HLLHHHLLHH
φυ^σήμα^τι^.	γηγενεῖ φυ^σήμα^τι^.	HLHLHLL	HLHHHLL
γεννά^δα_,	Ἀλλ' ὅπως, ὦ γεννά^δα_,	HLHHHLH	HLHHHLL
ἐπα^ναστρέφειν	ὁ δ' ἐπα^ναστρέφειν δύ^νηται κἀ_περείδεσθαι τορῶς.	LLLHLHLHHHLHHHLH	LLL-LHHHHLLHHHLH
δύ^νηται	ὁ δ' ἐπα^ναστρέφειν δύ^νηται κἀ_περείδεσθαι τορῶς.	LLLHLHLHHHLHHHLH	LLL-LHHHHLLHHHLH
χἄ_τεραι	εἰσβολαὶ γά^ρ εἰσι^ πολλαὶ χἄ_τεραι σοφισμά^των.	HLHLHLHHHLHLHLH	HLHLHLHHLLHLLLH
κἀ_ποκινδυ^νεύετον	τά^ τε πα^λαιὰ^ καὶ τὰ^ καινά^, κἀ_ποκινδυ^νεύετον λεπτόν τι^ καὶ σοφὸν λέγειν	LLLHLHLHLHLHLHLHHHLHLHLH	LLLHLHLHLLLHHHLHHHLHLHLH
κἀ_ποκινδυ^νεύετον	τά^ τε πα^λαιὰ^ καὶ τὰ^ καινά^, κἀ_ποκινδυ^νεύετον λεπτόν τι^ καὶ σοφὸν λέγειν	LLLHLHLHLHLHLHLHHHLHLHLH	LLLHLHLHLLLHHHLHHHLHLHLH
δεξι^ά_·	βιβλί^ον τ' ἔχων ἕκαστος μανθά^νει τὰ^ δεξι^ά_·	HLHLHLHHHLHLHLH	-LHLHL-HLLHLH-L
δεξι^ά_·	βιβλί^ον τ' ἔχων ἕκαστος μανθά^νει τὰ^ δεξι^ά_·	HLHLHLHHHLHLHLH	-LHLHL-HLLHLH-L
Πά^ρα^	Πά^ρα^ δὲ πολλοῖσιν μα^θεῖν.	LLLHHHLH	LHLHHLLH
πα^ρα^λι^πόντα^	τά^ τε μέγιστα^ πα^ρα^λι^πόντα^	LLLHLLLLHL	LLLLLLL-HL
στι^βά^δα^ς	πράγμα^τά^ τε καὶ στι^βά^δα^ς ἃ_ς ἔλα^χε Φορμί^ων·	HLLLHLLLHLLLHLH	HLLLH-LHHLLLHLH
στι^βά^δα^ς	πράγμα^τά^ τε καὶ στι^βά^δα^ς ἃ_ς ἔλα^χε Φορμί^ων·	HLLLHLLLHLLLHLH	HLLLH-LHHLLLHLH
παλίγκοτος	Μὴ γένῃ παλίγκοτος ἀντιβολοῦσιν ἡμῖν,  ὥστε τήνδε μὴ λα^βεῖν·	HLHHLHLHLH	HLHLHLLHLLHLHHHLHLHLH
ἀ^νερπύ^σαι.	δαιμόνι^α^ βουλόμενος εἰς ἀ^γρὸν ἀ^νερπύ^σαι.	HLLLHLLLHLLLHLH	HLLLHLLLH-LLHHH
γεωργικὸν	πᾶσι^ν ὁπόσοι γεωργικὸν βίον ἐτρίβομεν· μόνη γὰ^ρ ἡμᾶς ὠφέλεις.	HLLLHLHHLHHHLH	HLLLHLHLHLL-HLHLHLHHHLH
ἐτρίβομεν·	πᾶσι^ν ὁπόσοι γεωργικὸν βίον ἐτρίβομεν· μόνη γὰ^ρ ἡμᾶς ὠφέλεις.	HLLLHLHHLHHHLH	HLLLHLHLHLL-HLHLHLHHHLH
κἀ_δά^πα^να^	Πολλὰ^ γὰ^ρ ἐπάσχομεν πρίν ποτ' ἐπὶ^ σοῦ γλυ^κέα^ κἀ_δά^πα^να^ καὶ φί^λα_.	HLLLHLHHLLLHLLLHLLLHLH	HLLL-LHLLLLHLLLLLLLHLH
ἀμπέλι^α^	Ὥστε σὲ τά^ τ' ἀμπέλι^α^ καὶ τὰ^ νέα^ συ_κί^δι^α^ τἄλλα^ θ' ὁπόσ' ἐστὶ^ φυ^τὰ^ προσγελά^σεται λα^βόντ' ἄσμενα^.	HLLLHLLLHLLLHLLLHLLLHLLLHLLLHLHHLL	HLLLHL-LHLLHHL-LHLLLHLLLHLLLHLH-LL
νέα^	Ὥστε σὲ τά^ τ' ἀμπέλι^α^ καὶ τὰ^ νέα^ συ_κί^δι^α^ τἄλλα^ θ' ὁπόσ' ἐστὶ^ φυ^τὰ^ προσγελά^σεται λα^βόντ' ἄσμενα^.	HLLLHLLLHLLLHLLLHLLLHLLLHLLLHLHHLL	HLLLHL-LHLLHHL-LHLLLHLLLHLLLHLH-LL
συ_κί^δι^α^	Ὥστε σὲ τά^ τ' ἀμπέλι^α^ καὶ τὰ^ νέα^ συ_κί^δι^α^ τἄλλα^ θ' ὁπόσ' ἐστὶ^ φυ^τὰ^ προσγελά^σεται λα^βόντ' ἄσμενα^.	HLLLHLLLHLLLHLLLHLLLHLLLHLLLHLHHLL	HLLLHL-LHLLHHL-LHLLLHLLLHLLLHLH-LL
κἀ_πεμπίπτω	κἀ_πεμπίπτω καὶ σπουδάζω;	HHHHHHHH	LHHHHHHH
ἀντι^βολῇ	ἀντι^βολῇ μετὰ^ τῶν παίδων χορεῦσαι, μήθ' ὑ^πά^κουε μήτ' ἔλθῃς συ^νέρι_θος αὐτοῖς, ἀλλὰ^ νόμιζε πάντας	HLLHLLHHHLHHHLLHLHHHLLHLHHHLLHLHL	H-LHLLHHHLHHHLLHLHHHLLHLHHHLLHLLL
να_νοφυ^εῖς,	να_νοφυ^εῖς, σφυ^ρά^δων ἀ^ποκνήσμα^τα^, μηχα^νοδί_φας.	HLLHLLHLLHLLHLLHH	LLLHHLHL-HLLHLLLH
σφυ^ρά^δων	να_νοφυ^εῖς, σφυ^ρά^δων ἀ^ποκνήσμα^τα^, μηχα^νοδί_φας.	HLLHLLHLLHLLHLLHH	LLLHHLHL-HLLHLLLH
μηχα^νοδί_φας.	να_νοφυ^εῖς, σφυ^ρά^δων ἀ^ποκνήσμα^τα^, μηχα^νοδί_φας.	HLLHLLHLLHLLHLLHH	LLLHHLHL-HLLHLLLH
δα_μώμα^τα^	Τοιά^δε χρὴ Χα^ρί^των δα_μώμα^τα^ καλλι^κόμων	HLLHLLHHHLLHLLH	HH-HLLHLHLLH-LH
καλλι^κόμων	Τοιά^δε χρὴ Χα^ρί^των δα_μώμα^τα^ καλλι^κόμων	HLLHLLHHHLLHLLH	HH-HLLHLHLLH-LH
γηρύ_σαντος	πικροτά^την ὄπα^ γηρύ_σαντος ἤκουσ', ἡνί^κα^ τῶν τρα^γῳδῶν τὸν χορὸν εἶχον ἁ_δελφός τε καὶ αὐτός, ἄμφω	HLLHLLHHHLHHHLLHLHHHLLHLHHHLLHLHH	-LLHLLHLHLHHHLLHLHHHLLHLHHHLHHLHH
βα^τι^δοσκόποι	Γοργόνες ὀψοφά^γοι, βα^τι^δοσκόποι Ἅρπυιαι,	HLLHLLHLLHLLHHH	HLLHLLHL-HLHHHH
γρα_οσόβαι	γρα_οσόβαι μι^α^ροί, τρα^γομάσχα^λοι ἰχθυ^ολῦμαι·	HLLHLLHLLHLLHLLHH	LLLHLLHLL-LHHLLHH
θεὰ_	Μοῦσα^ θεὰ_ μετ' ἐμοῦ ξύμπαιζε τὴν ἑορτήν.	HLLHLLHHHLHLHH	HLLLLLHHHLHLHH
Εὐδαιμονι^κῶς	Εὐδαιμονι^κῶς γ' ὁ πρεσβύ_της, ὅσα^ γ' ὧδ' ἰ^δεῖν, τὰ^ νῦν τά^δε πράττει.	HHLLHLHHHLLHLHLHLLHH	HHL-H-HLHLLHLHLHL-HH
πρεσβύ_της,	Εὐδαιμονι^κῶς γ' ὁ πρεσβύ_της, ὅσα^ γ' ὧδ' ἰ^δεῖν, τὰ^ νῦν τά^δε πράττει.	HHLLHLHHHLLHLHLHLLHH	HHL-H-HLHLLHLHLHL-HH
ὄντα_;	Τί^ δῆτ', ἐπειδὰν νυμφί^ον μ' ὁρᾶτε λαμπρὸν ὄντα_;	LHLHHHLHLHLHLHH	LHLHLHLHLHLHLHL
κι^νεῖν	ἅ^παντα^ς ὄντα^ς ἀσφα^λῶς κι^νεῖν τε καὶ κα^θεύδειν.	LHLHLHLHLHLHLHH	LLLHLLLHHHLHLHH
εἰμι_.	Ὅταν τρυ^γᾶτ', εἴσεσθε πολλῷ μᾶλλον οἷός εἰμι_.	LHLHHHLHHHLHLHH	LLLHHHLHHHLHLHL
Τρυ^γαῖος	Πολλῶν γὰ^ρ ὑ_μῖν ἄ_ξι^ος Τρυ^γαῖος Ἁθμονεὺς ἐγώ,	HHLHHHLHLHLHLHLH	HHLHHLLHHHL-LHLH
νυ_ν	Ἄγ' ἐπείγετέ νυ_ν ἐν ὅσῳ σοβα^ρὰ_	LLHLLHLLHLLH	LLHLLLLLHLLL
σοβα^ρὰ_	Ἄγ' ἐπείγετέ νυ_ν ἐν ὅσῳ σοβα^ρὰ_	LLHLLHLLHLLH	LLHLLLLLHLLL
μετα^βι^βάζει.	εἰς ἀ^γα^θὰ^ μετα^βι^βάζει.	HLLLLLLHH	HLLLLL-LH
δευρὶ_	σχίζας δευρὶ_ τι^θέναι τα^χέως	HHHHLLHLLH	LHHLLLHLLH
σχίζα^	Ἡ σχίζα^ γοῦν ἐνημμένη τὸν Στιλβί^δην πι^έζει.	HHLHLHLHHHLHLHH	HLHHLHLHHHLHLHH
φι^ληδῶ	Οὐ γὰρ φι^ληδῶ μά^χαις,	HHLHHLH	HL-HHLH
ἂ^ν	ἐκκέας, τῶν ξύ^λων ἅττ' ἂ^ν ᾖ δα_νότα^τα^ τοῦ θέρους	HLHHLHHLHHLLLHLH	HL-HLHHHHLLLLHLH
δα_νότα^τα^	ἐκκέας, τῶν ξύ^λων ἅττ' ἂ^ν ᾖ δα_νότα^τα^ τοῦ θέρους	HLHHLHHLHHLLLHLH	HL-HLHHHHLLLLHLH
ἐκπεπρεμνισμένα_	ἐκπεπρεμνισμένα_	HLHHLH	H-H-LL
χἄ_μα^	χἄ_μα^ τὴν Θρᾷτταν κυ^νῶν	HLHHHLH	LHHHHLH
χἄ_μα^	χἄ_μα^ τὴν Θρᾷτταν κυ^νῶν	HLHHHLH	LHHHHLH
κἀ_πέχω	ἐσθί^ω κἀ_πέχω	HLHHLH	HLHLLH
χἄ_μα^	χἄ_μα^ φήμ'· «Ὧραι φί^λαι·» καὶ τοῦ θύ^μου τρί^βων κυ^κῶμαι·	HLHHHLHHHLHLHLHH	LHHHHLHHHLHHHLHH
χἄ_μα^	χἄ_μα^ φήμ'· «Ὧραι φί^λαι·» καὶ τοῦ θύ^μου τρί^βων κυ^κῶμαι·	HLHHHLHHHLHLHLHH	LHHHHLHHHLHHHLHH
τρί^βων	χἄ_μα^ φήμ'· «Ὧραι φί^λαι·» καὶ τοῦ θύ^μου τρί^βων κυ^κῶμαι·	HLHHHLHHHLHLHLHH	LHHHHLHHHLHHHLHH
δι^καστήρι^',	καὶ τέλη καὶ γρα^φαὶ καὶ δι^καστήρι^', ὦ βορβοροτά^ραξι^ καὶ τὴν πόλι^ν ἅ^πα_σα^ν ἡμῶν ἀ^να^τετυρβα^κώς,	HLHHLHHLHHLHHLLLHLHHLLLHLHHLLLHLH	HLHHLHHL-HHHHLLLHLHHLLLHLHHLLLHLH
κἀ_πὸ	κἀ_πὸ τῶν πετρῶν ἄ^νωθεν τοὺς φόρους θυννοσκοπῶν.	HLHLHLHHHLHHHLH	LLH-HLHHHLHHHLH
ἔπι^θι^	καὶ τὸ πρᾶγμ' ἦν ἄ^ρ' οὐ φαῦλον ὧδ'-u- ἄλλ' ἔπι^θι^ καὶ στρόβει, μηδὲν ὀλί^γον πόει· νῦν γὰ^ρ ἔχεται μέσος.	HLHHLHHLHHLHHLLLHLHHLLLHLHHLLLHLH	H-HHLHHLHHLLLHLHHLLLHLHHLLLHLH
ἔπι^θι^	καὶ τὸ πρᾶγμ' ἦν ἄ^ρ' οὐ φαῦλον ὧδ'-u- ἄλλ' ἔπι^θι^ καὶ στρόβει, μηδὲν ὀλί^γον πόει· νῦν γὰ^ρ ἔχεται μέσος.	HLHHLHHLHHLHHLLLHLHHLLLHLHHLLLHLH	H-HHLHHLHHLLLHLHHLLLHLHHLLLHLH
Κρα^τί_νου	Εἴ σε μὴ μι_σῶ, γενοίμην ἐν Κρα^τί_νου κῴδι^ον	HLHHHLHHHLHHHLH	HLHHHLHHHLLHH-H
κῴδι^ον	Εἴ σε μὴ μι_σῶ, γενοίμην ἐν Κρα^τί_νου κῴδι^ον	HLHHHLHHHLHHHLH	HLHHHLHHHLLHH-H
τρα^γῳδί^ᾳ.	καὶ δι^δασκοίμην προσᾴδειν Μορσί^μου τρα^γῳδί^ᾳ.	HLHHHLHHHLHLHLH	HLLHHLHHHLHLHHH
πυ_ροπί_πην,	Τὸν Οὐλί^ου τ' ἂ^ν οἴομαι, γέροντα^ πυ_ροπί_πην,	LHLHLHLHLHLHLHH	LHLHLHLHLHLLLLH
λαμπρυ_νομένων	μειρα^κί^ων θ' ἅ^μιλλα^ λαμπρυ_νομένων ἐν ἅρμα^σιν	HLLHLHLHHLLHLHLH	HLLHLHLHLLLHLLLL
Σουνι^ά^ρα_τε,	δεῦρ' ἔλθ' εἰς χορόν, ὦ χρυ_σοτρί^αιν', ὦδελφί_νων μεδέων Σουνι^ά^ρα_τε,	HHHLLHHLLHHHHHLLHHLLHL	HHHLLHH-LHHHHHLLHH-HLL
Σουνι^ά^ρα_τε,	δεῦρ' ἔλθ' εἰς χορόν, ὦ χρυ_σοτρί^αιν', ὦδελφί_νων μεδέων Σουνι^ά^ρα_τε,	HHHLLHHLLHHHHHLLHHLLHL	HHHLLHH-LHHHHHLLHH-HLL
Σουνι^ά^ρα_τε,	δεῦρ' ἔλθ' εἰς χορόν, ὦ χρυ_σοτρί^αιν', ὦδελφί_νων μεδέων Σουνι^ά^ρα_τε,	HHHLLHHLLHHHHHLLHHLLHL	HHHLLHH-LHHHHHLLHH-HLL
πολι^οῦχε	Ὦ πολι^οῦχε Παλλά^ς, ὦ τῆς ἱ^ερωτά^της ἁ^πα_σῶν πολέμῳ τε καὶ ποηταῖς δυ^νά^μει θ' ὑ^περφερούσης μεδέουσα^ χώρας,	HLLHLHLHHLLHLHLHHLLHLHLHHLLHLHLHHLLHLHH	HL-HLHHHHLLHLHLHHLLHLHLHHLLHLHLHHLLHLHH
Παλλά^ς,	Ὦ πολι^οῦχε Παλλά^ς, ὦ τῆς ἱ^ερωτά^της ἁ^πα_σῶν πολέμῳ τε καὶ ποηταῖς δυ^νά^μει θ' ὑ^περφερούσης μεδέουσα^ χώρας,	HLLHLHLHHLLHLHLHHLLHLHLHHLLHLHLHHLLHLHH	HL-HLHHHHLLHLHLHHLLHLHLHHLLHLHLHHLLHLHH
πά_σῃ	Νῦν οὖν δεῦρο φά^νηθι^· δεῖ γὰρ τοῖς ἀνδρά^σι^ τοῖσδε πά_σῃ τέχνῃ πορί^σαι σε νί_κην εἴπερ ποτὲ καὶ νῦν.	HHHLLHLHHHHLLHLHHHHLLHLHHHHLLHH	HHHLLHLHLHLLLHLLH-HLLHLHHHHLLHH
ἀ^γωνι^εῖ	Ἀλλ' ὅπως ἀ^γωνι^εῖ φρόν τιζε τἀ_πί^λοιπ' ἄ^ριστα^· συμμά^χους δ' ἡμᾶς ἔχων εὔνους ἐπίστα^σαι πά^λαι.	HLHLHLHHHLHLHLHLHLHHHLHHHLHLHLH	HLHLH-HHHLLLHLHLLLHHHLHHHL-LHLH
τἀ_πί^λοιπ'	Ἀλλ' ὅπως ἀ^γωνι^εῖ φρόν τιζε τἀ_πί^λοιπ' ἄ^ριστα^· συμμά^χους δ' ἡμᾶς ἔχων εὔνους ἐπίστα^σαι πά^λαι.	HLHLHLHHHLHLHLHLHLHHHLHHHLHLHLH	HLHLH-HHHLLLHLHLLLHHHLHHHL-LHLH
κά^λων	Νῦν δή σε πάντα^ δεῖ κά^λων ἐξι_έναι σεαυτοῦ,	HHLHLHLHHHLHLHH	HHLLLHHHHHLHLHH
θούρι^ον	καὶ λῆμα^ θούρι^ον φορεῖν καὶ λόγους ἀ^φύκτους,	HHLHLHLHHLHLHH	HHLH-HLHHLHLLH
ἄνδρα_.	Πρὸς ταῦθ' ὅπως ἔξει πολὺς καὶ λαμπρὸς εἰς τὸν ἄνδρα_.	HHLHLHLHHHLHLHH	HHLHHHLLHHLHLHL
τορύ_νη.	ὡς εἰ μὴ 'γένεθ' οὗτος ἐν τῇ πόλει μέγα^ς, οὐκ ἂ^ν ἤστην σκεύει δύ^ο χρησί^μω, δοῖδυξ οὐδὲ τορύ_νη.	HHHLLHLHHLHLLHLHHHHLLHLHHHHLLHH	HHHLLHLHHLHLLHLHHHHL-HLHHHHLLLH
δεδί^α_σί^	ἀρχήν, ὅτε πάντες ἄνθρωποι δεδί^α_σί^ σ' ὥσπερ ἄνδρα^ τύ^ραννον.	HHLLHLHHHLLHLHLHLLHL	HHLLHLHHHLHHLHLHLLLH
ἂ^ν	τούτων ὃς ἂ^ν ᾖ πα^χύς,	HHLLHLH	HHLHHLL
κἄ_μ'	αὐτοὺς περι^έρχομαι τοὺς οἰομένους φρονεῖν κἄ_μ' ἐξα^πα^τύλλειν.	HHLLHLHHHLLHLHHHLLHH	HHLLHLHHHLLHLHLHLLLH
Λυ_σίστρα^τον,	μηδὲν εἰς Λυ_σίστρα^τον,	HLHHHLH	HLHL-LH
ἀ^νέστι^ον	μηδὲ Θούμαντιν τὸν ἀ^νέστι^ον αὖ	HLHHHLLHLLH	HLHHLLLH-LH
Πυ_θῶνι^	Πυ_θῶνι^ δί_ᾳ μὴ κα^κῶς πένεσθαι.	HHLHHHLHLHH	LHLHHHLHLHH
γάρ	Φα_σὶ^ μὲν γάρ αὐτὸν ἐρεπτόμενον	HLHHHLLHLLH	HLHLHLLHLLH
βα^ρύ_νεται,	καὶ πα^λαιῷ Λακρα^τείδῃ τὸ σκέλος βα^ρύ_νεται,	HLHHHLHHHLHLHLH	HLHH-LHHHLHLLLH
Δι_ωκτέος	οἴχεται. Δι_ωκτέος δέ· μὴ γὰ^ρ ἐγχά^νοι ποτὲ	HLHHHLHLHLHLHLL	HLHLHLHLHLHLHLL
ἵ^να^	κοὐκ ἀ^νήσω πρὶ^ν ἂν σχοῖνος αὐτοῖσι^ν ἀντεμπα^γῶ καὶ σκόλοψ ὀξύ^ς, ὀδυ^νηρός, ἐπί^κωπος, ἵ^να^ μήποτε πα^τῶσι^ν ἔτι^ τὰ_ς ἐμὰ_ς ἀμπέλους.	HLHHLHHLHHLHHLHHLHHLLLHLLLHLLLHLLLHLLLHLHHLH	HLHHLHHLHHLHHLHHLHHLLLHLLLHLLHHLLLHLLLHLHHLH
τουτὶ_	Ἡρά^κλεις τουτὶ_ τί^ ἐστι^; τὴν χύ^τραν συντρίψετε.	HLHHHLHLHLHHHLL	H-HHLLHLH-HHHLL
μι^α^ρὰ_	Σὲ μὲν οὖν κα^τα^λεύσομεν, ὦ μι^α^ρὰ_ κεφα^λή.	LLHLLHLLHLLHLLH	LLHLLHLLH-LLLLH
μι^α^ρὰ_	Σὲ μὲν οὖν κα^τα^λεύσομεν, ὦ μι^α^ρὰ_ κεφα^λή.	LLHLLHLLHLLHLLH	LLHLLHLLH-LLLLH
ἠκούσα^τ';	Ἀντὶ^ δ' ὧν ἐσπεισά^μην ἠκούσα^τ'; Ἀλλ' ἀ^κούσα^τε.	HLHHHLHHHLHLHLL	HLHHHLHHHHHLHLL
φι^λανθρα^κέα_;	Ἀ^πολεῖς ἄ^ρ' ὁμήλι^κα^ τόνδε φι^λανθρα^κέα_;	LLHLLHLLHLLHLLH	LLHLLHLLHL-HLLL
φι^λανθρα^κέα_;	Ἀ^πολεῖς ἄ^ρ' ὁμήλι^κα^ τόνδε φι^λανθρα^κέα_;	LLHLLHLLHLLHLLH	LLHLLHLLHL-HLLL
Οὑτοιί_	Οὑτοιί_ σοι χα^μαί, καὶ σὺ^ κα^τά^θου πά^λιν τὸ ξί^φος.	HLHHLHHLLLHLHHLH	HHLHLHHLLLHLLHLH
ἁ_γὼν	ὡς σκῆψι^ν ἁ_γὼν οὗτος οὐκ εἰσδέξεται.	HHLHHHLHHHLH	HHLLHHLHHHLH
φλεγυ^ρὰ_	δεῦρο Μοῦσ' ἐλθὲ φλεγυ^ρὰ_ πυ^ρὸς ἔχουσα^ μένος,	HLHHLLLHLLLHLLL	HLHH-LLLHLLHLLH
πυ^ρὸς	δεῦρο Μοῦσ' ἐλθὲ φλεγυ^ρὰ_ πυ^ρὸς ἔχουσα^ μένος,	HLHHLLLHLLLHLLL	HLHH-LLLHLLHLLH
ἀ^νήλα^τ'	οἷον ἐξ ἀνθρά^κων πρι_νί^νων φέψα^λος ἀ^νήλα^τ' ἐρεθιζόμενος οὐρί^ᾳ ῥι_πί^δι^,	HLHHLHHLHHLLLHLLLHLLLHLHHLL	HLHHLHHLHHLLLHHLLHLLLHLH-LL
ῥι_πί^δι^,	οἷον ἐξ ἀνθρά^κων πρι_νί^νων φέψα^λος ἀ^νήλα^τ' ἐρεθιζόμενος οὐρί^ᾳ ῥι_πί^δι^,	HLHHLHHLHHLLLHLLLHLLLHLHHLL	HLHHLHHLHHLLLHHLLHLLLHLH-LL
ἂ^ν	ἡνί^κ' ἂ^ν ἐπανθρα^κί^δες ὦσι^ πα^ρα^κείμεναι,	HLLLHLLLHLLLHLH	HLHLHLLLHLLLHLH
Θα^σί^αν	οἱ δὲ Θα^σί^αν ἀ^να^κυ^κῶσι^ λι^πα^ράμπυ^κα^,	HLLLHLLLHLLLHLL	HLLLLLLLHL-LHLL
λι^πα^ράμπυ^κα^,	οἱ δὲ Θα^σί^αν ἀ^να^κυ^κῶσι^ λι^πα^ράμπυ^κα^,	HLLLHLLLHLLLHLL	HLLLLLLLHL-LHLL
τἀ_γορᾷ	οὐδ' ἐντυ^χὼν ἐν τἀ_γορᾷ πρόσεισί^ σοι βα^δίζων	HHLHHHLHLHLHLHH	HHLHHLLHLHLHLHH
τρι^ά_κονθ'	πλεῖν ἢ τρι^ά_κονθ' ἡμέρας τοῦ μηνὸς ἑκάστου.	HHLHHHLHHHLLHH	HH-LHHLHHHLL-H
τρι^ά_κονθ'	πλεῖν ἢ τρι^ά_κονθ' ἡμέρας τοῦ μηνὸς ἑκάστου.	HHLHHHLHHHLLHH	HH-LHHLHHHLL-H
ὑ^πευθύ_νους	κρα_τὴρ κα^κῶν, τριπτὴρ δι^κῶν, φαίνειν ὑ^πευθύ_νους λυ^χνοῦχος καὶ κύ^λιξ τὰ^ πρά_γμα^τ' ἐγκυ^κᾶσθαι.	HHLHHHLHHHLHHHLHHHLHLHLHLHH	HHLHHHLHHHLHLH-HHHLHL-LHLHH
κα^τα_γείη	Ἰσχυ_ρόν ἐστι^ν, ὦγά^θ', ὥστ' οὐκ ἂν κα^τα_γείη ποτ', εἴ περ ἐκ ποδῶν κα^τωκά^ρα_ κρέμαιτο.	HHLHLHLHHHLHHHLHLHLHLHLHLHL	-HLHLHLHHLLLHHLHLHLHLHL-LHL
ἠργά^σα^το	ἠργά^σα^το πάντα^ κα^κά^, κἀ_νέτρεπε κἀξέχει	HLLLHLLLHLLLHLH	HHLLLLLLL-LLHLH
κἀ_νέτρεπε	ἠργά^σα^το πάντα^ κα^κά^, κἀ_νέτρεπε κἀξέχει	HLLLHLLLHLLLHLH	HHLLLLLLL-LLHLH
κἀ_μά^χετο	κἀ_μά^χετο καὶ προσέτι^ πολλὰ^ προκα^λουμένου·	HLLLHLLLHLLLHLH	LLLLHLLLHLLLHLH
μεγά^λα^	Ἐπτέρωταί τ' ἐπὶ^ τὸ δεῖπνον ἅ^μα^ καὶ μεγά^λα^ δὴ φρονεῖ,	HLHHLLLHLLLHLLLHLH	HLHHLLLHLLLHLLHHLH
γερόντι^ον	Ἢ πά^νυ^ γερόντι^ον ἴ^σως νενόμι^κάς με σύ^;	HLLLHLLLHLLLHLL	HLLLH-LHHLLLLLL
ἴ^σως	Ἢ πά^νυ^ γερόντι^ον ἴ^σως νενόμι^κάς με σύ^;	HLLLHLLLHLLLHLL	HLLLH-LHHLLLLLL
νέα^	εἶτα^ πα^ρὰ^ τόνδε νέα^ μοσχί^δι^α^ συκί^δων,	HLLLHLLLHLLLHLH	HLLLHLLHHL-LHLH
μοσχί^δι^α^	εἶτα^ πα^ρὰ^ τόνδε νέα^ μοσχί^δι^α^ συκί^δων,	HLLLHLLLHLLLHLH	HLLLHLLHHL-LHLH
ὁδί_,	καὶ τὸ τρί^τον ἡμερί^δος ὄσχον, ὁ γέρων ὁδί_,	HLLLHLLLHLLLHLH	H-LLHLLLHLLLHLL
δειπνητι^κῶς	Ἤκουσα^ς ὡς μα^γειρι^κῶς κομψῶς τε καὶ δειπνητι^κῶς αὑτῷ δι^α_κονεῖται;	HHLHLHLHHHLHHHLHHHLHLHH	HHLHLHLHHHLHHH-HHH-LLHH
δι^α_κονεῖται;	Ἤκουσα^ς ὡς μα^γειρι^κῶς κομψῶς τε καὶ δειπνητι^κῶς αὑτῷ δι^α_κονεῖται;	HHLHLHLHHHLHHHLHHHLHLHH	HHLHLHLHHHLHHH-HHH-LLHH
δι^α_κονεῖται;	Ἤκουσα^ς ὡς μα^γειρι^κῶς κομψῶς τε καὶ δειπνητι^κῶς αὑτῷ δι^α_κονεῖται;	HHLHLHLHHHLHHHLHHHLHLHH	HHLHLHLHHHLHHH-HHH-LLHH
λι^μῷ	Ἀ^ποκτενεῖς λι^μῷ 'μὲ καὶ τοὺς γείτονας κνί_σῃ τε καὶ φωνῇ τοιαῦτα^ λάσκων.	LHLHLHLHHHLHHHLHHHLHLHH	LHLHHHLHHHLLLHLHHHHHL-H
κνί_σῃ	Ἀ^ποκτενεῖς λι^μῷ 'μὲ καὶ τοὺς γείτονας κνί_σῃ τε καὶ φωνῇ τοιαῦτα^ λάσκων.	LHLHLHLHHHLHHHLHHHLHLHH	LHLHHHLHHHLLLHLHHHHHL-H
ξυγγρα^φέα_,	Ἀντί^μα^χον τὸν Ψα^κά^δος, ξυγγρα^φέα_, τὸν μελέων ποιητήν,	HLLHHLLHHLLHHLLHLHH	HLLHHLLHHLLLHLLHHHH
ἀ^νόσι^ά^	προδεδόμεθ' ἀ^νόσι^ά^ τ' ἐπά^θομεν·	LLLLLLLLLLLL	LLLLLL-LLLLH
ἰ^ώ·	Ἰ^ὼ ἰ^ώ·	LHLH	HHHH
ἔπι^θ'	ἔπα^γ' ἔπι^θ' ἐπί^φερε πολέμι^ον	LLLLLLLLLLLL	LLL-LLLLLLLH
Πα_νὶ^	Πα_νὶ^ νόμους ἱ^εροὺς ἀ^να^φαίνω	HLLHLLHLLHH	LLLHLLHLLHH
χορεύμα^τ'	σεμνά^ τε Μητρὶ^ χορεύμα^τ' ὀρείᾳ,	HLLHLLHLLHH	HLLHLLHHLHH
συμμι^γῆ	συμμι^γῆ βοὴν ὁμοῦ πτεροῖσι^ κρέκοντες ἴ^ακχον Ἀ^πόλλω,	HLHLHLHLHLLHLLHLLHH	L-HLHLHLHLLHLLHLLHH
αἰθέρι^ον	δι^ὰ^ δ' αἰθέρι^ον νέφος ἦλθε βοά_·	LLHLLHLLHLLH	LLHL-HLLHLLL
βοά_·	δι^ὰ^ δ' αἰθέρι^ον νέφος ἦλθε βοά_·	LLHLLHLLHLLH	LLHL-HLLHLLL
ποικί^λα^	πτῆξε δὲ φῦλά^ τε ποικί^λα^ θηρῶν,	HLLHLLHLLHH	HLLHLLHLHHH
προσόδι^α^	προσόδι^α^ μεγά^λα^ σεμνὰ^ προσι^έναι θεοῖσι^ν, ἅ^μα^ δὲ προσέτι^ χά^ρι^τος ἕνεκα^ προβά^τι^όν τι^ θύ_ειν.	LLLLLLLHLLLLHLHLLLLLLLLLLLLLLLLHLHH	LL-LLLHHLLLLHLHLLL-LLLLLLLLLLL-HLHH
μεγά^λα^	προσόδι^α^ μεγά^λα^ σεμνὰ^ προσι^έναι θεοῖσι^ν, ἅ^μα^ δὲ προσέτι^ χά^ρι^τος ἕνεκα^ προβά^τι^όν τι^ θύ_ειν.	LLLLLLLHLLLLHLHLLLLLLLLLLLLLLLLHLHH	LL-LLLHHLLLLHLHLLL-LLLLLLLLLLL-HLHH
προβά^τι^όν	προσόδι^α^ μεγά^λα^ σεμνὰ^ προσι^έναι θεοῖσι^ν, ἅ^μα^ δὲ προσέτι^ χά^ρι^τος ἕνεκα^ προβά^τι^όν τι^ θύ_ειν.	LLLLLLLHLLLLHLHLLLLLLLLLLLLLLLLHLHH	LL-LLLHHLLLLHLHLLL-LLLLLLLLLLL-HLHH
Πυ_θι^ὰς	Ἴ^τω ἴ^τω ἴ^τω δὲ Πυ_θι^ὰς βοά_, συ^ναυλείτω δὲ Χαῖρι^ς ᾠδᾷ.	LHLHLHLHLHLHLHHHLHLHH	LHLHLHLL-HLLLHHHLHLHH
Πυ_θι^ὰς	Ἴ^τω ἴ^τω ἴ^τω δὲ Πυ_θι^ὰς βοά_, συ^ναυλείτω δὲ Χαῖρι^ς ᾠδᾷ.	LHLHLHLHLHLHLHHHLHLHH	LHLHLHLL-HLLLHHHLHLHH
βοά_,	Ἴ^τω ἴ^τω ἴ^τω δὲ Πυ_θι^ὰς βοά_, συ^ναυλείτω δὲ Χαῖρι^ς ᾠδᾷ.	LHLHLHLHLHLHLHHHLHLHH	LHLHLHLL-HLLLHHHLHLHH
τἄ_ρα^	Εἶτ' αὖθι^ς αὖ τἄ_ρα^ σοι	HHLHHLH	HHLHLLH
θύ_μα^τ'	Τὰ^ γὰρ πα^ρόντα^ θύ_μα^τ' οὐδὲν ἄλλο πλὴν γένειόν τ' ἐστὶ^ καὶ κέρα_τα^.	LHLHLHLHLHLHLHHHLHLHL	LLLHLLLHLH-HLHHHLHLLL
κέρα_τα^.	Τὰ^ γὰρ πα^ρόντα^ θύ_μα^τ' οὐδὲν ἄλλο πλὴν γένειόν τ' ἐστὶ^ καὶ κέρα_τα^.	LHLHLHLHLHLHLHHHLHLHL	LLLHLLLHLH-HLHHHLHLLL
λά^θῃ	μή σε λά^θῃ θεῶν τις ταύτῃ περῶν.	HLLHLHHHHLH	HLHHLHLHHLH
πολυ^ά_νορα^	Τά^χα^ δὴ πολυ^ά_νορα^ τάνδε πόλιν	LLHLLHLLHLLH	LLHLLLLLHLLL
ὡδί_.	τύπτων γε τοῦτον ὡδί_.	HHLHLHH	HHLHLHL
Μα_νῆς	Μα_νῆς γά^ρ ἐστι^ δειλός.	HHLHLHH	LHLHLHH
μαντι^κὰ^	τά^ τε μουσί^χ' ὁμοῦ τά^ τε μαντι^κὰ^ καὶ τὰ^ θα^λάττι^'. Ἔπειτα^ δ' ὅπως φρονί^μως	LLHLLHLLHLLHLLHLLHLLHLLH	LLHLLHLLH-LHLLLLLHLLHLLH
πράγμα^τ'	Πολλὰ^ δὴ καὶ καινὰ^ καὶ θαυμάστ' ἐπεπτόμεσθα^ καὶ δεινὰ^ πράγμα^τ' εἴδομεν.	HLHHHLHHHLHLHLHHLHLHLH	HLHHHLHH-LHLHLHHL-HHLH
ἀ_εὶ	Τοῦτο τοῦ μὲν ἦρος ἀ_εὶ	HLHLHLHH	HLHLHLLH
ξυ^να_ριστῶσι^	ἔνθα^ τοῖς ἥρωσι^ν ἄνθρωποι ξυ^να_ριστῶσι^ καὶ ξύ^νεισι^ πλὴν τῆς ἑσπέρας.	HLHHHLHHHLHHHLHLHLHHHLH	HLHHHLHHHLL-HLHLHLHHHLH
τἀ_πὶ^	γυμνὸς ἦν πληγεὶς ὑ^π' αὐτοῦ πάντα^ τἀ_πὶ^ δεξι^ά_.	HLHHHLHHHLHLHLH	HLHHHLHHLLLLH-L
δεξι^ά_.	γυμνὸς ἦν πληγεὶς ὑ^π' αὐτοῦ πάντα^ τἀ_πὶ^ δεξι^ά_.	HLHHHLHHHLHLHLH	HLHHHLHHLLLLH-L
δεξι^ά_.	γυμνὸς ἦν πληγεὶς ὑ^π' αὐτοῦ πάντα^ τἀ_πὶ^ δεξι^ά_.	HLHHHLHHHLHLHLH	HLHHHLHHLLLLH-L
Σκι^ά_ποσιν	Πρὸς δὲ τοῖς Σκι^ά_ποσιν λίμνη τι^ς ἔστ', ἄ^λουτος οὗ ψυ_χα^γωγεῖ Σωκρά^της.	HLHLHLHHHLHLHLHHLHHHLH	HLH-LLLHHLHLHLHHLHHHLH
Σκι^ά_ποσιν	Πρὸς δὲ τοῖς Σκι^ά_ποσιν λίμνη τι^ς ἔστ', ἄ^λουτος οὗ ψυ_χα^γωγεῖ Σωκρά^της.	HLHLHLHHHLHLHLHHLHHHLH	HLH-LLLHHLHLHLHHLHHHLH
προὔλι^πε,	Ἔνθα^ καὶ Πείσανδρος ἦλθε δεόμενος ψυ_χὴν ἰ^δεῖν ἣ ζῶντ' ἐκεῖνον προὔλι^πε,	HLHHHLHLLLLHHHLHHHLHHHLH	HLHHHLHLLLLHHHLHHHLHHH-L
τρυ_γῶσι^	οἳ θερίζουσίν τε καὶ σπείρουσι^ καὶ τρυ_γῶσι^ ταῖς γλώτταισι^ συ_κά^ζουσί^ τε·	HLHHHLHHHLHHHLHHHLHLHLL	HLHHLLHHHLHLHLHHHLLHHLL
συ_κά^ζουσί^	οἳ θερίζουσίν τε καὶ σπείρουσι^ καὶ τρυ_γῶσι^ ταῖς γλώτταισι^ συ_κά^ζουσί^ τε·	HLHHHLHHHLHHHLHHHLHLHLL	HLHHLLHHHLHLHLHHHLLHHLL
Φί^λιπποι.	βάρβα^ροι δ' εἰσὶν γένους, Γοργί^αι τε καὶ Φί^λιπποι. Κἀ_πὸ τῶν ἐγγλωττογαστόρων ἐκείνων τῶν Φι^λίππων	HLHHHLHHLHLHLHHHLHHHLHLHLHHHLHH	LLHHLLHHLHLHLHHLLHHHL-LHLHHH-HH
Ἀττι^κῆς	παντα^χοῦ τῆς Ἀττι^κῆς ἡ γλῶττα^ χωρὶς τέμνεται.	HLHHHLHHHLHHHLH	HLHHH-HHHLHLHLH
ξυ^νεκοίμι^σαν	Μοῖραι ξυ^νεκοίμι^σαν	HHLLHLH	HHLLH-L
ὑ^μεναίῳ.	ἐν τοιῷδ' ὑ^μεναίῳ.	LHHLLHH	HHHHLHH
Τουτὶ_	Τουτὶ_ μέντοι θαυμαστόν,	HHHHHHL	HLHHH-H
εὐά_γητον	ἀρθῶμεν φα^νεραὶ δροσερὰν φύ^σι^ν εὐά_γητον	HHHLLHLLHLLHHHH	HHHLLHLLHLLHLHH
βα^ρυ^α_χέος	πατρὸς ἀ^π' Ὠκεα^νοῦ βα^ρυ^α_χέος	HLLHLLHLLHLL	-LLHLLHLLLLH
ἔπι^	ὑψηλῶν ὀρέων κορυ^φὰ_ς ἔπι^ δενδροκόμους, ἵ^να^ τηλεφα^νεῖς σκοπι^ὰς ἀ^φορώμεθα^	HHHLLHLLHLLHLLHLLHLLHLLHLLHLL	HHHLLHLLHL-HLLHLHHLLHLLHLLHLL
ἵ^να^	ὑψηλῶν ὀρέων κορυ^φὰ_ς ἔπι^ δενδροκόμους, ἵ^να^ τηλεφα^νεῖς σκοπι^ὰς ἀ^φορώμεθα^	HHHLLHLLHLLHLLHLLHLLHLLHLLHLL	HHHLLHLLHL-HLLHLHHLLHLLHLLHLL
ἀ_κά^μα^τον	ὄμμα^ γὰ^ρ αἰθέρος ἀ_κά^μα^τον σελα^γεῖται	HLLHLLHLLHLLHH	HLLHLLLLLHLLHH
ὄμβρι^ον	ἀλλ' ἀ^ποσεισά^μεναι νέφος ὄμβρι^ον	HLLHLLHLLHLL	HLLHLLHLLH-H
σέβα^ς	οὗ σέβα^ς ἀρρήτων ἱ^ερῶν, ἵ^να^ μυστοδόκος δόμος ἐν τελεταῖς ἁ^γί^αις ἀ^να^δείκνυ^ται·	HLLHHHLLHLLHLLHLLHLLHLLHLLHLL	HLHHHHLLHLH-LLHLLHLLHLLHLLHLH
ἵ^να^	οὗ σέβα^ς ἀρρήτων ἱ^ερῶν, ἵ^να^ μυστοδόκος δόμος ἐν τελεταῖς ἁ^γί^αις ἀ^να^δείκνυ^ται·	HLLHHHLLHLLHLLHLLHLLHLLHLLHLL	HLHHHHLLHLH-LLHLLHLLHLLHLLHLH
τρι^αίνης	τόν τε μεγασθενῆ τρι^αίνης τα^μί^αν, γῆς τε καὶ ἁλμυ^ρᾶς θα^λάσσης ἄ^γρι^ον μοχλευτήν·	HLLHLHLHHLLHHLLHLHLHHLLHLHH	HLL-LH-HHLLHHLHHLHL-H-LH-HH
ὑψι^κέρα_τα^	ὑψι^κέρα_τα^ πέτραν·	HLLHLHH	LLLLL-H
πολι^οῦχος	ἥ τ' ἐπι^χώρι^ος ἡμετέρα_ θεὸς αἰγί^δος ἡνί^οχος, πολι^οῦχος Ἀ^θά_να_·	HLLHLLHLLHLLHLLHLLHLLHLLHH	HLLHLLHLLHLLHLLHLLHL-HLHLL
πολι^οῦχος	ἥ τ' ἐπι^χώρι^ος ἡμετέρα_ θεὸς αἰγί^δος ἡνί^οχος, πολι^οῦχος Ἀ^θά_να_·	HLLHLLHLLHLLHLLHLLHLLHLLHH	HLLHLLHLLHLLHLLHLLHL-HLHLL
Ἀ^θά_να_·	ἥ τ' ἐπι^χώρι^ος ἡμετέρα_ θεὸς αἰγί^δος ἡνί^οχος, πολι^οῦχος Ἀ^θά_να_·	HLLHLLHLLHLLHLLHLLHLLHLLHH	HLLHLLHLLHLLHLLHLLHL-HLHLL
Ἀ^θά_να_·	ἥ τ' ἐπι^χώρι^ος ἡμετέρα_ θεὸς αἰγί^δος ἡνί^οχος, πολι^οῦχος Ἀ^θά_να_·	HLLHLLHLLHLLHLLHLLHLLHLLHH	HLLHLLHLLHLLHLLHLLHL-HLHLL
Δι^όνυ_σος.	κωμαστὴς Δι^όνυ_σος.	HHHLLHH	H-H-LLH
Δι^όνυ_σος.	κωμαστὴς Δι^όνυ_σος.	HHHLLHH	H-H-LLH
δι^ά^θρει	φρόντιζε δὴ καὶ δι^ά^θρει πάντα^ τρόπον τε σαυτὸν	HHLHHLLHHLLHLHH	HHLHH-LHLLLHLHH
ὡδὶ_	μι_μούμενος καὶ τοῖν ποδοῖν ὡδὶ_ πα^ρενσα^λεύων	HHLHHHLHHHLHLHH	HHLHHHLHHLLHLHH
τουτονὶ_	βληχώμενοι σὲ τουτονὶ_ πεινῶντα^ κα^τα^λα^βόντες,	HHLHLHLHHHLLLLHH	HHLHLHLLHHLLLLHH
γρυ_λίζοντες	ὑ_μεῖς δὲ γρυ_λίζοντες ὑ^πὸ φι^ληδί^ας	HHLHHHLLLLHLH	HH-LHHLLL-HLH
φι^ληδί^ας	ὑ_μεῖς δὲ γρυ_λίζοντες ὑ^πὸ φι^ληδί^ας	HHLHHHLLLLHLH	HH-LHHLLL-HLH
μολύ_νουσάν	καὶ μαγγα^νεύουσαν μολύ_νουσάν τε τοὺς ἑταίρους	HHLHHHLHHHLHLHH	HHLHHLLLHLLHLHH
τὸνχθιζι^νὸν	τά^χα^ δ' ἂν δι^ὰ^ τὸνχθιζι^νὸν ἄνθρωπον, ὃς ἡμᾶς δι^έδυ_ πως	LLHLLHHLLHHLLHHLLHH	LLLLLHH-LHHLLHH-LHH
ἴ^σως	εἶτ' ἴ^σως κεῖται πυ^ρέττων.	HLHHHLHH	HHHHHLHH
ἁ_νήρ.	ἔστι^ γὰρ τοιοῦτος ἁ_νήρ.	HLHHHLHH	HLLHHLLH
τἀ_πὶ^	ἔσθι^ε, μηδ' ἀ^γα^νάκτει. καὶ γὰ^ρ ἀ^νὴρ πα^χὺ^ς ἥκει τῶν προδόντων τἀ_πὶ^ Θρᾴκης·	HLLHLLHHHLLHLLHHHLHHHLHH	HLLHLLLHHLLHLLHHHLHHL-HH
πα_πί^α^·	μὰ^ Δί^', ἀλλ' ἰσχά^δα^ς, ὦ πα_πί^α^· ἥδι^ον γά^ρ— οὐκ ἂν μὰ^ Δί^', εἰ κρέμαισθέ γ' ὑ_μεῖς.	LLHHLLHHLLHLHLHHLLHLHLHH	LLH-LLHLLHH-HLHLLLHLHLHH
πα_πί^α^·	μὰ^ Δί^', ἀλλ' ἰσχά^δα^ς, ὦ πα_πί^α^· ἥδι^ον γά^ρ— οὐκ ἂν μὰ^ Δί^', εἰ κρέμαισθέ γ' ὑ_μεῖς.	LLHHLLHHLLHLHLHHLLHLHLHH	LLH-LLHLLHH-HLHLLLHLHLHH
ἥδι^ον	μὰ^ Δί^', ἀλλ' ἰσχά^δα^ς, ὦ πα_πί^α^· ἥδι^ον γά^ρ— οὐκ ἂν μὰ^ Δί^', εἰ κρέμαισθέ γ' ὑ_μεῖς.	LLHHLLHHLLHLHLHHLLHLHLHH	LLH-LLHLLHH-HLHLLLHLHLHH
τἄ_ρα^	μὰ^ Δί^' οὔ τἄ_ρα^ προπέμψω σε τὸ λοιπόν.	LLHHLLHHLLHH	LLHLLLHHLLHH
νυ_ν,	ἄ^γε νυ_ν, ὦ πά^τερ, ἢν μὴ τὸ δι^καστήρι^ον ἅρχων	LLHHLLHHLLHHLLHH	LLLHLLHHLL-H-LHH
δι^καστήρι^ον	ἄ^γε νυ_ν, ὦ πά^τερ, ἢν μὴ τὸ δι^καστήρι^ον ἅρχων	LLHHLLHHLLHHLLHH	LLLHLLHHLL-H-LHH
ἄ_ριστον;	κα^θί^σῃ νῦν, πόθεν ὠνησόμεθ' ἄ_ριστον; ἔχεις ἐλπί^δα^ χρηστήν τι^να^ νῷν ἢ πόρον Ἕλλας ἱερόν;	LLHHLLHHLLHHLLHHLLHHLLHH	LLHHLLHHLLL-LLHHLLHHLLHHLLHHLLH
θυ_λά^κι^ον,	ἀ^νόνητον ἄ^ρ', ὦ θυ_λά^κι^ον, σ' εἶχον ἄ^γαλμα^.	LLHLLHHLLHHLLHL	LLHLLHHL-HHLLLL
κἀ_ποκλείων	κἀ_ποκλείων τῇ θύ^ρᾳ; λέξον· πρὸς εὔνους γὰρ φρά^σεις.	HLHHHLHHHLHHHLH	L-HHHLHHHLHHLLH
ἁ_νὴρ	τοῦτ' ἐτόλμησ' ὁ μι^α^ρὸς χα^νεῖν, ὁ Δημολογοκλέων ὅδ', ὅτι^ λέγεις σύ^ τι^ περὶ^ τῶν νεῶν ἀ^ληθές; οὐ γὰ^ρ ἄν ποθ' οὗτος ἁ_νὴρ τοῦτ' ἐτόλμησεν λέγειν, εἰ μὴ ξυ^νωμότης τι^ς ἦν.	HLHHLLLHLHLHLLLLHLLLLHLLLLHLHLHLHLHLHLHHHLHHHLHHHLHLHLH	HLHHLLLHLHLHLL-LHLLLLHLLLLHLHLHLHLLLHLLHHLHHHLHHHLHLHLH
δι^α^τρα^γεῖν	δι^α^τρα^γεῖν τοίνυν κρά^τιστόν ἐστί^ μοι τὸ δίκτυ^ον.	LLLHHHLHLHLHLHLH	--LHHLLLLHLHLHLH
δέδι^θι^,	μηδέν, ὦ τᾶν, δέδι^θι^, μηδέν· ὡς ἐγὼ τοῦτόν γ', ἐὰν γρύξῃ τι^, ποιήσω δα^κεῖν τὴν καρδί^αν καὶ τὸν περὶ ψυ_χῆς δρόμον δρα^μεῖν, ἵ^ν' εἰδῇ μὴ πα^τεῖν τὰ^ ταῖν θεαῖν ψηφίσμα^τα^.	HLHHLLLHLHLHHHLHHHLHHHLHHHLHHHLHHHLHLHLHHHLHLHLHHHLL	HLHHL-LHLHLHHHLLHHLHHHLHHHLHHHLLHHLHLHLHHHLHLHLHHLLL
γὰρ	τόνδε λέγειν. ὁρᾷς γὰρ ὥς σοι μέγα^ς ἐστὶ^ν ἁ_γὼν	HLLHLHH	HLLHLHLHHLLHLLH
ὁδί_	τί^ γάρ φα^θ' ὑ_μεῖς, ἢν ὁδί_ με τῷ λόγῳ κρα^τήσῃ;	LHLHHHLHLHLHLHH	LLLHHHLLLHLHLHH
εἰμι_.	κα^λῶς γὰ^ρ ᾔδειν ὡς ἐγὼ ταύτῃ κρά^τιστός εἰμι_.	LHLHHHLHHHLHLHH	LHLHHHLHHHLLLHL
πράγμα^θ',	νενουθέτηκεν αὑτὸν ἐς τὰ^ πράγμα^θ', οἷς	LHLHLHLHLHLH	LHLHLHLHL-HH
Πύ_θι^',	ὦ Φοῖβ' Ἄ^πολλον Πύ_θι^', ἐπ' ἀ^γα^θῇ τύ^χῃ	HHLHHHLLLLHLH	HHLHHL-LLLHLH
Πύ_θι^',	ὦ Φοῖβ' Ἄ^πολλον Πύ_θι^', ἐπ' ἀ^γα^θῇ τύ^χῃ	HHLHHHLLLLHLH	HHLHHL-LLLHLH
νεα^νι^κὴν	νεα^νι^κὴν σχεῖν· ὡς ἐγὼ τοὐμὸν νομίζω	LLLHHHLHHHLHH	LH-HHHLHHHLHH
νεα^νι^κὴν	νεα^νι^κὴν σχεῖν· ὡς ἐγὼ τοὐμὸν νομίζω	LLLHHHLHHHLHH	LH-HHHLHHHLHH
νεα^νι^ῶν	γῆρα^ς εἶναι κρεῖττον ἢ πολλῶν κι^κίννους νεα^νι^ῶν καὶ} [σχῆμα^ κεὐρυ^πρωκτί^αν.	HLHHHLHHHLHHLLLHHLHLHLH	HLHHHLHHHLLHLHLHHHLH-HLH
κεὐρυ^πρωκτί^αν.	γῆρα^ς εἶναι κρεῖττον ἢ πολλῶν κι^κίννους νεα^νι^ῶν καὶ} [σχῆμα^ κεὐρυ^πρωκτί^αν.	HLHHHLHHHLHHLLLHHLHLHLH	HLHHHLHHHLLHLHLHHHLH-HLH
ἂ^ν	τά^χα^ δ' ἂ^ν ἴ^σως οὐκ ἐθέλοι·	LLLLHHLLH	LLLHHHLLH
ἀ^εί.	φύ^σεως, ἣν ἔχοι τι^ς, ἀ^εί.	LHHLHLLH	LLHHLHLLH
φι^λοπα^τρί^αν	τυ^χὼν ἄ^πεισιν δι^ὰ^ τὴν φι^λοπα^τρί^αν καὶ σοφί^αν	LHLHHLLHLLLLHHLLL	LHLHLLLH-L-LHHLLH
Φι^λοκλέωνος.	ὁ παῖς ὁ Φι^λοκλέωνος.	LHLLLLHL	LHL--LHH
Ἀ_γι^δῶς	Ἀ_γι^δῶς τὸ φῶς· ὁρῶ	HLHLHLH	L-HLHLH
Ἀ_γι^δῶς	Ἀ_γι^δῶς τὸ φῶς· ὁρῶ	HLHLHLH	L-HLHLH
ἄ_λι^ον,	ϝ' ὥτ' ἄ_λι^ον, ὅνπερ ἇμι_ν	HHLLHLHH	HL-LHLHL
ἄ_λι^ον,	ϝ' ὥτ' ἄ_λι^ον, ὅνπερ ἇμι_ν	HHLLHLHH	HL-LHLHL
Ἀ_γι^δὼ	Ἀ_γι^δὼ μαρτύ_ρεται	HLHHHLH	L-HHLLH
Ἀ_γι^δὼ	Ἀ_γι^δὼ μαρτύ_ρεται	HLHHHLH	L-HHLLH
μαρτύ_ρεται	Ἀ_γι^δὼ μαρτύ_ρεται	HLHHHLH	L-HHLLH
νι^ν	οὔτε μωμήσθαι νι^ν ἁ_ κλεννὰ_ χορα_γὸς	HLHHHLHHHLHH	HLHHH-HHLLLH
κλεννὰ_	οὔτε μωμήσθαι νι^ν ἁ_ κλεννὰ_ χορα_γὸς	HLHHHLHHHLHH	HLHHH-HHLLLH
χορα_γὸς	οὔτε μωμήσθαι νι^ν ἁ_ κλεννὰ_ χορα_γὸς	HLHHHLHHHLHH	HLHHH-HHLLLH
ἁ^μῶς	οὐδ' ἁ^μῶς ἐῆι· δοκεῖ γὰ^ρ ἤμεν αὔτα_	HLHLHLHLHLHH	HHHLHLHLHLHL
αὔτα_	οὐδ' ἁ^μῶς ἐῆι· δοκεῖ γὰ^ρ ἤμεν αὔτα_	HLHLHLHLHLHH	HHHLHLHLHLHL
στά_σειεν	ἐκπρεπὴς τὼς ὥπερ αἴ τι^ς ἐν βοτοῖς στά_σειεν ἵππον	HLHHHLHLHLHHHLHH	HLHHHLHLHLHLHLHH
πα_γὸν	πα_γὸν ἀ^εθλοφόρον κα^να^χά_ποδα^	HLLHLLHLLHLL	LLL-LLHLLLLL
κα^να^χά_ποδα^	πα_γὸν ἀ^εθλοφόρον κα^να^χά_ποδα^	HLLHLLHLLHLL	LLL-LLHLLLLL
ἁ_γὼ	ἁ_γὼ δι^καιῶν μὴ πα^ρ' ἀγγέλων, τέκνα^,	HHLHHHLHLHHL	LHLHHHLHLH-L
κα^τοικτί_ρων	εἴην τοιάνδε μὴ οὐ κα^τοικτί_ρων ἕδρα_ν.	HHLHLLHLHHHLH	HHHHLHHLHLH-H
θα_κεῖ,	ἀ^γοραῖσι^ θα_κεῖ, πρός τε Παλλά^δος δι^πλοῖς	LLHLHHHLHLHLH	LLHLLHHLHLH-H
Θουκυ_δί^δης	Θουκυ_δί^δης Ἀ^θηναῖος ξυ^νέγρα^ψε τὸν πόλεμον τῶν Πελοποννησί^ων 	HHLHLHHHLHHLHLLHHLLHHLH	HLLHLHHHL-LLHLLHHLLHHLH
Καλλι^όπη	Καλλι^όπη φα^έθοντα^, τὸν Εὐ_ρυ^φά^εσσα^ βοῶπι_ς  	HLLHLLHLLHLLHLLHH	H-LHLLHLLHLLHLLHL
Ὑ^περί_ων	γῆμε γὰ^ρ Εὐ_ρυ^φά^εσσα^ν ἀ^γακλειτὴν Ὑ^περί_ων	HLLHLLHLLHHHLLHH	HLLHLLHLLLHHLLLH
κα_λὸν	τηλαυγές· κα_λὸν δὲ περὶ^ χροῒ^ λάμπεται ἔσθος	HHHHHLLHLLHLLHH	HHHLHLLLLLHLHHH
ἡμι^θέων	ἡμι^θέων ὧν ἔργα^ θεοὶ θνητοῖσι^ν ἔδειξα^ν.	HLLHHHLLHHHLLHH	H-LHHHLLHHHLLHL
ἰ_τέα^ν	Ἐγκέλα^δον ἰ_τέα^ν ἐς μέσην θενὼν δορὶ^	HLLLHLLHLHLHLL	HLLLHLHHLHLHLL
